11111111111
1009000D001
1000000000
11111111111