1111111111
100C000011
1P000E0011
1111111111