1111111111111111111111
100C010CC0000000000111
10000E0111000000000111
11P00G1111111111111111
1111111111111111111111