1111111111111
100C010111111
1P000E0111111
1110011111111
1111111111111