111111111111
1P0C010E0011
100000000111
100G00000001
111111111111