111111111111
100C01000011
1000P0000111
11000G000001
111111111111