111111111111
1P0C01000011
1G0000000111
1E0000000001
111111111111
111111111111
100C01000011
100000000111
100000000001
111111111111
111111111111
100C01000011
100000000111
100000000001
111111111111
111111111111
100C01000011
100000000111
100000000001
111111111111
111111111111
100C01000011
100000000111
100000000001
111111111111
111111111111
100C01000011
100000000111
100000000001
111111111111
111111111111
100C01000011
100000000111
100000000001
111111111111
111111111111
100C01000011
100000000111
100000000001
111111111111
111111111111
100C01000011
100000000111
100000000001
111111111111
111111111111
100C01000011
100000000111
100000000001
111111111111
111111111111
100C01000011
100000000111
100000000001
111111111111
111111111111
100C01000011
100000000111
100000000001
111111111111
111111111111
100C01000011
100000000111
100000000001
111111111111