111111111111
100C01000011
1000P0E00111
11000G000001
1111111111111111